tile.png
60 30
0 0 0 0 0 0 0 0 0 0 0 0 0 0 0 0 0 0 0 0 0 0 0 0 0 0 0 0 0 0 0 0 0 0 0 0 0 0 0 0 0 0 0 0 0 0 0 0 0 0 0 0 0 0 0 0 0 0 0 0
0 80 80 80 80 80 80 80 80 80 80 80 80 80 80 80 80 80 80 80 80 80 80 80 80 80 80 80 80 80 80 80 80 80 80 80 80 80 80 80 80 80 80 80 80 80 80 80 80 80 80 80 80 80 80 80 80 80 80 0
0 80 80 80 80 80 80 80 80 80 80 80 80 80 80 80 80 80 80 80 80 80 80 80 80 80 80 80 80 80 80 80 80 80 80 80 80 80 80 80 80 80 80 80 80 80 80 80 80 80 80 80 80 80 80 80 80 80 80 0
0 80 80 80 80 80 80 80 80 80 80 80 80 80 80 80 80 80 80 80 80 80 80 80 80 80 80 80 80 80 80 80 80 80 80 80 80 80 80 80 80 80 80 80 80 80 80 80 80 80 80 80 80 80 80 80 80 80 80 0
0 80 80 80 80 80 80 80 80 80 80 80 80 80 80 80 80 80 80 80 80 80 80 80 80 80 80 80 80 80 80 80 80 80 80 80 80 80 80 80 80 80 80 80 80 80 80 80 80 80 80 80 80 80 80 80 80 80 80 0
0 10 10 10 10 80 80 80 80 80 80 80 80 80 80 80 80 80 80 10 10 10 10 10 10 80 80 80 80 80 80 80 80 80 80 80 80 80 80 80 80 80 80 80 80 80 80 80 80 80 80 80 80 80 80 80 80 80 80 0
0 80 80 80 10 10 10 10 10 10 10 10 10 10 10 80 80 80 80 80 80 80 80 80 80 80 80 80 80 80 80 80 80 80 80 80 80 80 80 80 80 80 80 80 80 80 80 80 80 80 80 80 80 80 80 80 80 10 80 0
0 80 80 80 80 80 80 80 80 80 80 80 80 80 10 10 10 80 80 80 80 80 80 80 80 80 80 80 80 80 80 80 80 80 80 10 80 80 80 80 80 80 80 80 80 80 80 80 80 80 80 80 80 10 10 10 10 10 80 0
0 80 80 80 80 80 80 80 80 80 80 80 80 80 80 80 10 10 80 80 80 80 80 80 80 80 80 80 80 80 10 10 10 10 10 80 80 80 80 80 80 80 80 80 80 80 80 80 80 80 10 10 10 10 80 80 80 80 80 0
0 80 80 80 80 80 80 80 80 80 80 80 80 80 80 80 80 80 80 80 80 80 80 80 80 80 10 10 10 10 10 80 80 80 80 80 80 80 80 10 10 10 10 10 10 10 10 10 10 10 10 80 80 80 80 80 80 80 80 0
0 80 80 80 80 80 80 80 80 80 80 80 80 80 80 80 80 80 80 80 80 80 80 10 10 10 80 80 80 80 80 80 80 80 80 80 80 80 10 80 80 80 80 80 80 80 80 80 80 80 80 80 80 80 80 80 80 80 80 0
0 80 80 80 80 80 80 80 80 80 80 80 80 80 80 80 80 80 80 80 80 10 10 10 80 80 80 80 80 80 80 80 80 80 80 80 80 80 80 80 80 80 80 80 80 80 80 80 80 80 80 80 80 80 80 80 80 80 80 0
0 80 80 80 80 80 80 80 80 80 80 80 80 80 80 80 80 10 10 10 10 10 80 80 80 80 80 80 80 80 80 80 80 80 80 80 80 80 80 80 80 80 80 80 80 80 80 80 80 80 80 80 80 80 80 80 80 80 80 0
0 80 80 80 80 80 80 80 10 10 10 10 10 10 10 10 10 10 80 80 80 80 80 80 80 80 80 80 80 80 80 80 80 80 80 10 10 80 80 80 80 80 80 80 80 80 80 80 80 80 80 80 80 80 80 80 80 80 80 0
0 80 80 80 80 80 10 10 80 80 80 80 80 80 80 80 80 80 80 80 80 80 80 80 80 80 80 80 80 80 80 80 80 80 10 80 80 10 80 80 80 80 80 80 80 80 80 80 80 80 80 80 80 80 80 80 80 80 80 0
0 80 80 80 80 80 80 80 80 80 80 80 80 80 80 80 80 80 80 80 80 80 80 80 80 80 80 80 80 80 80 80 80 80 80 80 80 80 10 10 10 10 10 10 10 80 80 80 80 80 80 80 80 80 80 80 80 80 80 0
0 80 80 80 80 80 80 80 80 80 80 80 80 80 80 80 80 80 80 80 80 80 80 80 80 80 80 80 80 80 80 80 80 80 80 80 80 80 80 80 80 80 80 80 80 10 10 10 80 80 80 80 80 80 80 80 80 80 80 0
0 10 10 80 80 80 80 80 80 80 80 80 80 80 80 80 80 80 80 80 80 80 80 80 80 10 10 10 10 10 80 80 80 80 80 80 80 80 80 80 80 80 80 80 80 80 80 10 10 80 80 80 80 80 80 80 80 80 80 0
0 80 10 10 80 80 80 80 80 80 80 80 80 80 80 80 80 80 80 80 80 80 80 80 10 80 80 80 80 10 10 10 10 10 10 80 80 80 80 80 80 80 80 80 80 80 80 80 80 80 80 80 80 80 80 80 10 10 10 0
0 80 80 10 10 10 80 80 80 80 80 80 80 80 80 80 80 80 80 80 80 80 80 80 80 80 80 80 80 80 80 80 80 80 80 10 80 80 80 80 80 80 80 80 80 80 80 80 80 80 80 80 80 80 10 10 10 80 80 0
0 80 80 80 80 80 10 10 80 80 80 80 80 80 80 80 80 80 80 80 80 80 80 80 80 80 80 80 80 80 80 80 80 80 80 80 10 80 80 80 80 80 80 80 80 80 80 80 80 80 10 10 10 10 10 80 80 80 80 0
0 80 80 80 80 80 80 10 10 10 80 80 80 80 80 80 80 80 80 80 80 80 80 80 80 80 80 80 80 80 80 80 80 80 80 80 80 80 80 80 80 80 80 10 10 10 10 10 10 10 10 80 80 80 80 80 80 80 80 0
0 80 80 80 80 80 80 80 80 80 10 10 10 80 80 80 80 80 80 80 80 80 10 10 10 10 80 80 80 80 80 80 80 80 80 80 80 80 80 10 10 10 10 10 80 80 80 80 80 80 80 80 80 80 80 80 80 80 80 0
0 80 80 80 80 80 80 80 80 80 80 80 80 10 10 80 80 80 80 80 80 80 80 80 80 10 10 10 80 80 80 80 80 80 80 80 80 80 80 80 80 80 80 80 80 80 80 80 80 80 80 80 80 80 80 80 80 80 80 0
0 80 80 80 80 80 80 80 80 80 80 80 80 80 10 10 10 10 10 80 80 80 80 80 80 80 80 10 10 10 10 10 10 10 80 80 80 80 80 80 80 80 80 80 80 80 80 80 80 80 80 80 80 80 80 80 80 80 80 0
0 80 80 80 80 80 80 80 80 80 80 80 80 80 80 80 80 80 10 10 10 80 80 80 80 80 80 80 80 80 80 80 80 10 10 10 10 10 10 80 80 80 80 80 80 80 80 80 80 80 80 80 80 80 80 80 80 80 80 0
0 80 80 80 80 80 80 80 80 80 80 80 80 80 80 80 80 80 80 80 80 80 80 80 80 80 80 80 80 80 80 80 80 80 80 80 80 80 80 80 80 80 80 80 80 80 80 80 80 80 80 80 80 80 80 80 80 80 80 0
0 80 80 80 80 80 80 80 80 80 80 80 80 80 80 80 80 80 80 80 80 80 80 80 80 80 80 80 80 80 80 80 80 80 80 80 80 80 80 80 80 80 80 80 80 80 80 80 80 80 80 80 80 80 80 80 80 80 80 0
0 80 80 80 80 80 80 80 80 80 80 80 80 80 80 80 80 80 80 80 80 80 80 80 80 80 80 80 80 80 80 80 80 80 80 80 80 80 80 80 80 80 80 80 80 80 80 80 80 80 80 80 80 80 80 80 80 80 80 0
0 0 0 0 0 0 0 0 0 0 0 0 0 0 0 0 0 0 0 0 0 0 0 0 0 0 0 0 0 0 0 0 0 0 0 0 0 0 0 0 0 0 0 0 0 0 0 0 0 0 0 0 0 0 0 0 0 0 0 0