tile.png
100 30
6 6 6 6 6 6 6 6 6 6 6 6 6 6 6 6 6 6 6 6 6 6 6 6 6 6 6 6 6 6 6 6 6 6 6 6 6 6 6 6 6 6 6 6 6 6 6 6 6 6 6 6 6 6 6 6 6 6 6 6 6 6 6 6 6 6 6 6 6 6 6 6 6 6 6 6 6 6 6 6 6 6 6 6 6 6 6 6 6 6 6 6 6 6 6 6 6 6 6 6
6 86 86 86 86 86 86 86 86 86 86 86 86 86 86 86 86 86 86 86 86 86 86 86 86 86 86 86 86 86 86 86 86 86 86 86 86 86 86 86 86 86 86 86 86 86 86 86 86 86 86 86 86 86 86 86 86 86 86 86 86 86 86 86 86 86 86 86 86 86 86 86 86 86 86 86 86 86 86 86 86 86 86 86 86 86 86 86 86 86 86 86 86 86 86 86 86 86 86 6
6 86 86 86 86 86 86 86 86 86 86 86 86 86 86 86 86 86 86 86 86 86 86 86 86 86 86 86 86 86 86 86 86 86 86 86 86 86 86 86 86 86 86 86 86 86 86 86 86 86 86 86 86 86 86 86 86 86 86 86 86 86 86 86 86 86 86 86 86 86 86 86 86 86 86 86 86 86 86 86 86 86 86 86 86 86 86 86 86 86 86 86 86 86 86 86 86 86 86 6
6 86 86 86 86 86 86 86 86 86 86 86 86 86 86 86 86 86 86 86 86 86 86 86 86 86 86 86 86 86 86 86 86 86 86 86 86 86 86 86 86 86 86 86 86 86 86 86 86 86 86 86 86 86 86 86 86 86 86 86 86 86 86 86 86 86 86 86 86 86 86 86 86 86 86 86 86 86 86 86 86 86 86 86 86 86 86 86 86 86 86 86 86 86 86 86 86 86 86 6
6 86 86 86 86 86 86 86 86 86 86 86 86 86 86 86 86 86 86 86 86 86 86 86 86 86 86 86 86 86 86 86 86 86 86 86 86 86 86 86 86 86 86 86 86 86 86 86 86 86 86 86 86 86 86 86 86 86 86 86 86 86 86 86 86 86 86 86 86 86 86 86 86 86 86 86 86 86 86 86 86 86 86 86 86 86 86 86 86 86 86 86 86 86 86 86 86 86 86 6
6 86 86 86 86 86 86 86 86 86 36 36 36 36 86 86 86 86 86 86 86 86 86 86 86 86 86 86 86 86 86 86 86 86 36 36 36 86 86 86 86 86 86 86 86 86 86 86 86 86 86 86 86 86 86 86 86 86 86 86 86 86 86 86 86 86 86 86 86 86 86 86 86 86 86 86 86 86 86 86 86 86 86 86 86 86 86 86 86 86 86 86 86 86 86 86 86 86 86 6
6 36 36 86 86 86 86 86 36 36 86 86 86 36 36 36 36 36 36 36 36 86 86 86 86 86 86 86 86 86 36 36 36 36 36 86 36 36 36 36 36 86 86 86 86 86 86 86 86 86 86 86 86 86 86 86 86 86 86 86 86 86 86 86 86 36 36 36 36 36 36 36 86 86 86 86 86 86 86 86 86 86 86 86 86 86 86 86 86 86 86 86 86 86 86 86 86 86 86 6
6 86 36 36 86 86 86 86 86 86 86 86 86 86 86 86 86 86 86 86 36 36 86 86 86 86 86 86 86 86 86 86 86 86 86 86 86 86 86 86 36 36 36 36 86 86 86 86 86 86 86 86 86 86 86 86 86 86 86 86 86 86 86 86 36 86 86 86 86 86 86 86 36 36 36 36 36 86 86 86 86 86 86 86 86 86 36 36 86 86 86 86 86 86 86 86 86 86 86 6
6 86 86 36 36 86 86 86 86 86 86 86 86 86 86 86 86 86 86 86 86 36 36 36 36 36 86 86 86 86 86 86 86 86 86 86 86 86 86 86 86 86 86 86 86 86 86 86 86 86 86 86 86 86 86 86 86 86 86 86 86 86 86 86 86 86 86 86 86 86 86 86 86 86 86 86 86 36 86 86 86 86 86 86 86 86 86 36 36 36 86 86 86 86 86 86 86 86 86 6
6 86 86 86 36 36 36 86 86 86 86 86 86 86 86 86 86 86 86 86 86 86 86 86 86 36 36 36 86 86 86 86 86 86 86 86 86 86 86 86 86 86 86 86 86 86 86 86 86 86 86 86 86 86 86 36 36 36 36 86 86 86 86 86 86 86 86 86 86 86 86 86 86 86 86 86 86 86 86 86 86 86 36 36 86 86 86 86 86 36 36 36 36 36 86 86 86 86 86 6
6 86 86 86 86 86 86 36 36 86 86 86 86 86 86 86 86 86 86 86 86 86 86 86 86 86 86 86 86 86 86 86 86 86 86 86 86 86 86 86 86 86 86 86 86 36 36 36 36 36 86 86 86 86 86 86 86 86 36 36 36 36 36 86 86 86 86 86 86 86 86 86 86 86 86 86 86 86 86 86 36 36 36 86 86 86 86 86 86 86 86 86 86 36 36 36 36 86 86 6
6 86 86 86 86 86 86 86 36 36 86 86 86 86 86 86 86 86 86 86 86 86 86 86 86 86 86 86 86 86 86 86 86 86 86 86 86 86 86 86 86 86 86 86 36 86 86 86 86 36 36 36 86 86 86 86 86 86 86 86 86 86 36 36 36 36 86 86 86 86 86 86 86 86 86 86 86 86 86 36 36 86 86 86 86 86 86 86 86 86 86 86 86 86 86 86 36 36 36 6
6 86 86 86 86 86 86 86 86 36 36 86 86 86 86 86 86 86 86 86 86 86 86 86 86 86 86 86 86 86 36 36 36 36 36 36 36 36 36 36 86 86 86 86 86 86 86 86 86 86 86 36 36 86 86 86 86 86 86 86 86 86 86 86 86 36 36 86 86 86 86 86 86 86 86 86 86 86 36 36 86 86 86 86 86 86 86 86 86 86 86 86 86 86 86 86 86 86 86 6
6 86 86 86 86 86 86 86 86 36 36 36 36 86 86 86 36 36 36 36 86 86 86 86 86 86 86 86 86 86 86 86 86 86 86 86 86 86 86 86 86 86 86 86 86 86 86 86 86 86 86 86 86 86 86 86 86 86 86 86 86 86 86 86 86 86 36 36 86 86 86 86 86 86 86 86 86 36 36 86 86 86 86 86 86 86 86 86 86 86 86 86 86 86 86 86 86 86 86 6
6 86 86 86 86 86 86 86 86 86 86 86 86 86 86 86 86 86 86 86 86 86 86 36 36 36 36 36 86 86 86 86 86 86 86 86 86 86 86 86 36 36 86 86 86 86 86 86 86 86 86 86 86 86 86 86 86 86 86 86 86 86 86 86 86 86 86 86 36 36 86 86 86 86 86 86 36 36 86 86 86 86 86 86 86 86 86 86 86 86 86 86 86 86 86 86 86 86 86 6
6 86 86 86 86 86 86 86 86 86 86 86 86 86 86 86 86 86 86 86 86 86 86 86 86 86 86 86 86 86 86 86 86 86 86 86 86 86 86 86 86 36 36 36 36 36 36 36 86 86 86 86 86 86 86 86 86 86 86 86 86 86 86 86 86 86 86 86 86 36 86 86 86 86 36 36 36 86 86 86 86 86 86 86 86 86 86 86 86 86 86 86 86 86 86 86 86 86 86 6
6 86 86 86 86 86 86 86 86 86 86 86 86 86 86 86 86 86 86 86 86 86 86 86 86 86 86 86 86 86 86 86 86 86 86 86 86 86 86 86 86 86 86 86 86 86 86 86 86 86 86 86 86 36 36 36 36 86 86 86 86 86 86 86 86 86 86 86 86 86 86 86 86 36 36 86 86 86 86 86 86 86 86 86 86 86 86 86 36 36 36 36 36 86 86 86 86 86 86 6
6 86 86 86 86 86 86 86 86 36 36 36 36 36 36 36 36 36 36 86 86 86 86 86 86 86 86 36 36 36 36 86 86 86 86 86 86 86 86 86 86 86 86 86 86 86 86 86 86 86 86 36 36 86 86 86 86 36 36 36 36 86 86 86 86 86 86 86 86 86 86 86 86 86 86 86 86 86 86 86 86 36 36 36 36 36 36 36 36 86 86 86 86 86 86 86 86 86 36 6
6 86 86 86 86 86 86 86 86 86 86 86 86 86 86 86 86 86 86 86 86 86 86 86 86 86 86 86 86 86 86 86 86 86 86 86 86 86 86 86 86 86 86 86 86 86 86 86 86 86 86 86 86 86 86 86 86 86 86 86 36 36 36 36 36 36 36 86 86 86 86 86 86 86 86 86 86 86 86 86 86 86 86 86 86 86 86 86 86 86 86 86 86 86 86 86 36 36 36 6
6 86 86 86 86 86 86 86 86 86 86 86 86 86 86 86 86 86 86 86 36 36 36 86 86 86 86 86 86 86 86 86 86 86 86 86 86 86 86 86 86 86 86 86 86 86 86 86 86 86 86 86 86 86 86 86 86 86 86 86 86 86 86 86 86 86 86 86 86 86 36 36 36 86 86 86 86 86 86 86 86 86 86 86 86 86 86 86 86 86 86 86 86 86 86 36 36 86 86 6
6 86 86 86 86 86 86 86 86 86 86 86 86 86 86 86 86 86 86 86 86 86 86 86 86 86 86 86 86 86 86 86 86 86 86 86 86 86 86 86 86 86 86 86 86 86 86 86 86 86 86 86 86 86 86 86 86 86 86 86 86 86 86 86 86 86 86 86 86 86 86 86 36 36 36 36 36 36 36 36 86 86 86 86 86 86 86 86 86 86 86 86 86 86 36 36 86 86 86 6
6 36 36 36 36 36 36 36 36 86 86 86 86 86 86 86 86 86 86 86 86 86 86 36 36 36 36 86 86 86 86 36 36 36 36 86 86 86 86 86 36 36 36 36 36 86 86 86 86 36 36 36 36 36 36 36 86 86 86 86 86 86 86 86 86 86 86 86 86 86 86 86 86 86 86 86 86 86 86 86 86 86 36 36 36 86 86 86 36 36 36 36 36 36 86 86 86 86 86 6
6 86 86 86 86 86 86 86 86 86 86 86 86 86 86 86 86 86 86 86 86 86 86 86 86 86 86 86 86 86 86 86 86 86 86 86 86 86 86 86 86 86 86 86 86 86 86 86 86 86 86 86 86 86 86 86 86 86 86 86 86 86 86 86 86 86 86 86 86 86 86 86 86 86 86 86 86 86 86 86 86 86 86 86 86 86 86 86 86 86 86 86 86 86 86 86 86 86 86 6
6 86 86 86 86 86 86 86 86 86 86 86 86 86 86 86 86 86 86 86 86 86 86 86 86 86 86 86 86 86 86 86 86 86 86 86 86 86 86 86 86 86 86 86 86 86 86 86 86 86 86 86 86 86 86 86 86 86 86 86 86 86 86 86 86 86 86 36 36 36 86 86 86 86 86 86 86 86 86 86 86 36 86 86 86 36 86 86 86 86 86 86 86 86 86 86 86 86 86 6
6 86 86 86 86 86 86 86 86 86 86 86 86 86 86 86 86 86 86 86 86 86 86 86 86 86 86 86 86 86 86 86 86 86 86 86 86 86 86 86 86 86 86 86 86 86 86 86 86 86 86 86 86 86 86 86 86 86 86 86 86 86 86 86 86 86 86 86 86 86 86 86 86 86 86 86 86 86 86 86 36 36 86 86 86 36 36 86 86 86 86 86 86 86 86 86 86 86 86 6
6 36 36 36 36 36 36 36 36 36 36 36 36 36 36 36 86 86 86 86 36 36 36 36 36 36 36 36 36 36 86 86 86 86 86 86 36 36 36 36 36 36 36 36 36 36 36 36 36 36 86 86 86 86 86 36 36 36 36 36 36 36 36 36 36 36 86 86 86 86 86 86 36 36 36 36 36 36 36 36 36 36 86 86 86 36 36 36 36 36 36 36 86 86 86 86 86 86 86 6
6 86 86 86 86 86 86 86 86 86 86 86 86 86 86 86 86 86 86 86 86 86 86 86 86 86 86 86 86 86 86 86 86 86 86 86 86 86 86 86 86 86 86 86 86 86 86 86 86 86 86 86 86 86 86 86 86 86 86 86 86 86 86 86 86 86 86 86 86 86 86 86 86 86 86 86 86 86 86 86 86 86 86 86 86 86 86 86 86 86 86 86 86 86 86 86 86 86 86 6
6 86 86 86 86 86 86 86 86 86 86 86 86 86 86 86 86 86 86 86 86 86 86 86 86 86 86 86 86 86 86 86 86 86 86 86 86 86 86 86 86 86 86 86 86 86 86 86 86 86 86 86 86 86 86 86 86 86 86 86 86 86 86 86 86 86 86 86 86 86 86 86 86 86 86 86 86 86 86 86 86 86 86 86 86 86 86 86 86 86 86 86 86 86 86 86 86 86 86 6
6 86 86 86 86 86 86 86 86 86 86 86 86 86 86 86 86 86 86 86 86 86 86 86 86 86 86 86 86 86 86 86 86 86 86 86 86 86 86 86 86 86 86 86 86 86 86 86 86 86 86 86 86 86 86 86 86 86 86 86 86 86 86 86 86 86 86 86 86 86 86 86 86 86 86 86 86 86 86 86 86 86 86 86 86 86 86 86 86 86 86 86 86 86 86 86 86 86 86 6
6 6 6 6 6 6 6 6 6 6 6 6 6 6 6 6 6 6 6 6 6 6 6 6 6 6 6 6 6 6 6 6 6 6 6 6 6 6 6 6 6 6 6 6 6 6 6 6 6 6 6 6 6 6 6 6 6 6 6 6 6 6 6 6 6 6 6 6 6 6 6 6 6 6 6 6 6 6 6 6 6 6 6 6 6 6 6 6 6 6 6 6 6 6 6 6 6 6 6 6
