tile.png
100 30
5 5 5 5 5 5 5 5 5 5 5 5 5 5 5 5 5 5 5 5 5 5 5 5 5 5 5 5 5 5 5 5 5 5 5 5 5 5 5 5 5 5 5 5 5 5 5 5 5 5 5 5 5 5 5 5 5 5 5 5 5 5 5 5 5 5 5 5 5 5 5 5 5 5 5 5 5 5 5 5 5 5 5 5 5 5 5 5 5 5 5 5 5 5 5 5 5 5 5 5
5 85 85 85 85 85 85 85 85 85 85 85 85 85 85 85 85 85 85 85 85 85 85 85 85 85 85 85 85 85 85 85 85 85 85 85 85 85 85 85 85 85 85 85 85 85 85 85 85 85 85 85 85 85 85 85 85 85 85 85 85 85 85 85 85 85 85 85 85 85 85 85 85 85 85 85 85 85 85 85 85 85 85 85 85 85 85 85 85 85 85 85 85 85 85 85 85 85 85 5
5 85 85 85 85 85 85 85 85 85 85 85 85 85 85 85 85 85 85 85 85 85 85 85 85 85 85 85 85 85 85 85 85 85 85 85 85 85 85 85 85 85 85 85 85 85 85 85 85 85 85 85 85 85 85 85 85 85 85 85 85 85 85 85 85 85 85 85 85 85 85 85 85 85 85 85 85 85 85 85 85 85 85 85 85 85 85 85 85 85 85 85 85 85 85 85 85 85 85 5
5 85 85 85 85 85 85 85 85 85 85 85 85 85 85 85 85 85 85 85 85 85 85 85 85 85 85 85 85 85 85 85 85 85 85 85 85 85 85 85 85 85 85 85 85 85 85 85 85 85 85 85 85 85 85 85 85 85 85 85 85 85 85 85 85 85 85 85 85 85 85 85 85 85 85 85 85 85 85 85 85 85 85 85 85 85 85 85 85 85 85 85 85 85 85 85 85 85 85 5
5 85 85 85 85 85 85 85 85 85 85 85 85 85 85 85 85 85 85 85 85 85 85 85 85 85 85 85 85 85 85 85 85 85 85 85 85 85 85 85 85 85 85 85 85 85 85 85 85 85 85 85 85 85 85 85 85 85 85 85 85 85 85 85 85 85 85 85 85 85 85 85 85 85 85 85 85 85 85 85 85 85 85 85 85 85 85 85 85 85 85 85 85 85 85 85 85 85 85 5
5 85 85 85 85 85 85 85 85 85 85 85 85 85 85 85 85 85 85 85 85 85 35 85 85 85 85 85 85 85 85 85 85 85 85 85 85 85 85 85 85 85 85 85 85 85 85 85 85 85 85 85 85 85 85 85 85 85 85 85 85 85 85 85 85 85 85 85 85 85 85 85 85 35 35 35 35 85 85 85 85 85 85 85 85 85 85 85 85 85 85 85 85 85 85 85 85 85 85 5
5 85 85 35 35 35 35 35 85 85 85 85 85 85 85 85 85 85 85 85 85 85 35 35 35 35 35 85 85 85 85 85 85 85 85 85 85 85 85 85 85 85 85 85 35 35 35 35 35 85 85 85 85 85 85 85 85 85 85 85 85 85 85 85 85 85 85 85 85 85 85 35 35 85 85 85 35 35 85 85 85 85 85 85 85 85 85 85 85 85 85 85 85 85 85 85 85 35 35 5
5 85 85 85 85 85 85 35 35 35 35 85 85 85 85 85 85 85 85 85 85 85 85 85 85 85 85 85 85 85 85 85 85 85 85 85 35 85 85 85 85 85 85 35 85 85 85 85 35 35 85 85 85 85 85 85 85 85 85 85 85 85 85 35 35 35 35 35 85 85 85 85 85 85 85 85 85 35 35 35 85 85 85 85 85 85 85 85 85 85 85 85 85 35 35 35 35 35 85 5
5 35 85 85 85 85 85 85 85 85 85 85 85 85 85 85 35 35 35 35 35 85 85 85 85 85 85 85 85 85 85 85 85 85 85 35 35 35 85 85 85 85 85 85 85 85 85 85 85 35 35 35 85 85 85 85 85 85 85 85 85 85 35 35 85 85 85 85 85 85 85 85 85 85 85 85 85 85 85 35 35 35 35 85 85 85 85 85 85 85 85 85 85 85 85 85 85 85 85 5
5 85 85 85 85 85 85 85 85 85 85 85 85 85 35 35 35 85 85 85 85 85 85 85 85 85 85 85 85 85 85 85 85 85 85 85 85 35 35 85 85 85 85 85 85 85 85 85 85 85 85 85 35 85 85 85 85 85 85 85 35 35 35 85 85 85 85 85 85 85 85 85 85 85 85 85 85 85 85 85 85 85 85 35 35 35 35 35 85 85 85 85 85 85 85 85 85 85 85 5
5 85 85 85 85 85 85 85 85 85 85 85 85 85 85 85 85 85 85 85 85 85 85 85 85 85 35 35 35 35 35 35 35 35 85 85 85 85 35 35 35 35 85 85 85 85 85 85 85 85 85 85 85 85 85 85 35 35 35 35 35 85 85 85 85 85 85 85 85 85 35 35 35 35 35 85 85 85 85 85 85 85 85 85 85 85 85 35 35 35 35 35 85 85 85 85 85 85 85 5
5 85 35 85 85 85 85 85 85 85 85 35 85 85 85 85 85 85 85 85 85 85 85 85 85 85 85 85 85 85 85 85 85 85 85 85 85 85 85 85 85 85 35 85 85 85 85 85 85 85 85 85 85 85 85 85 85 85 85 85 85 85 85 85 85 85 85 85 85 85 85 85 85 85 35 35 35 85 85 85 85 85 85 85 85 85 85 85 85 85 85 85 35 35 85 85 85 85 85 5
5 85 85 85 85 85 85 85 85 85 85 85 85 85 85 85 85 85 85 85 85 85 85 85 85 85 85 85 85 85 85 85 85 85 85 85 85 85 85 85 85 85 85 35 85 85 85 85 85 85 85 85 85 85 85 85 85 85 85 85 85 85 85 85 85 85 85 85 85 85 85 85 85 85 85 85 85 35 85 85 85 85 85 85 85 85 85 85 85 85 85 85 85 85 35 85 85 85 85 5
5 85 85 85 35 85 85 85 85 35 85 85 85 85 35 35 85 85 85 85 85 85 85 85 85 85 85 85 85 85 85 85 85 85 85 85 85 85 85 85 85 85 85 85 85 85 85 85 85 85 35 85 85 85 85 85 85 85 85 85 85 85 85 85 85 85 85 85 85 85 85 85 85 85 85 85 85 85 85 85 85 85 85 85 85 85 85 85 85 85 85 85 85 85 85 85 85 85 85 5
5 85 85 85 85 85 85 85 85 85 85 85 85 85 85 35 35 35 35 35 35 85 85 85 85 85 85 85 85 85 35 85 85 85 85 85 85 35 85 85 35 85 85 85 85 85 35 35 85 85 85 85 35 35 35 35 35 35 35 35 85 85 85 85 35 35 35 35 35 35 85 85 85 85 85 85 85 85 85 85 85 85 85 85 85 85 85 85 85 85 85 85 85 85 85 85 85 35 35 5
5 85 85 85 85 85 85 85 85 85 85 85 85 85 85 85 85 85 85 85 35 35 85 85 35 35 85 85 85 35 85 85 35 85 85 85 85 85 85 85 85 85 85 85 85 85 85 85 85 85 85 85 85 85 85 85 85 85 85 35 35 35 35 35 85 85 85 85 85 85 85 85 85 85 85 85 85 85 85 35 85 85 85 85 85 85 85 85 85 85 85 85 85 85 85 85 35 35 85 5
5 35 35 85 85 85 85 85 85 35 35 35 85 85 85 85 85 85 85 85 85 85 85 85 85 85 85 85 85 85 85 85 85 85 85 85 85 85 85 85 85 85 35 85 85 85 85 85 85 85 85 85 85 85 85 85 85 85 85 85 85 85 85 85 85 85 85 85 85 85 85 85 85 85 85 85 35 35 35 35 35 35 85 85 85 85 85 85 85 85 85 85 85 35 35 35 85 85 85 5
5 85 35 35 35 35 85 85 85 85 85 85 35 85 85 85 85 85 85 85 85 85 85 85 85 85 85 85 35 85 85 85 85 85 85 35 85 85 85 85 85 85 35 35 85 85 85 85 85 85 85 85 85 85 85 85 85 85 85 85 85 85 85 85 85 85 85 85 85 85 85 85 85 85 85 85 85 85 85 85 85 35 35 85 85 85 85 85 85 85 85 85 85 85 85 85 85 85 85 5
5 85 85 85 85 35 35 85 85 85 85 85 85 35 85 85 85 85 85 85 85 85 85 85 85 85 85 85 85 85 85 85 85 85 85 85 85 85 85 85 85 85 85 35 35 35 35 85 85 85 85 85 85 85 85 85 85 85 85 85 85 85 85 85 85 85 85 85 85 85 85 85 85 85 85 85 85 85 85 85 85 85 85 35 35 35 35 35 35 35 85 85 85 85 85 85 85 85 85 5
5 85 85 85 85 85 35 35 85 85 85 85 85 85 85 85 85 85 85 85 35 35 85 85 85 85 85 85 85 85 85 85 85 85 85 85 85 85 85 85 85 85 85 85 85 85 85 85 85 35 85 85 85 85 85 85 85 85 85 85 85 85 85 85 85 85 85 85 85 85 35 35 35 35 85 85 85 85 85 85 85 85 85 85 85 85 85 85 85 85 35 35 85 85 85 85 85 85 85 5
5 85 85 85 85 85 85 35 35 85 85 85 85 85 85 85 85 85 85 85 85 35 35 35 35 35 35 85 85 85 85 85 85 85 85 85 85 35 35 85 85 85 85 85 85 85 85 85 35 85 35 85 85 85 85 85 85 85 85 85 85 85 85 85 85 85 85 85 35 35 85 85 85 85 35 35 35 85 85 85 85 85 85 85 85 85 85 85 85 85 85 85 85 85 85 85 85 85 85 5
5 85 85 85 85 85 85 85 35 35 85 85 85 85 85 85 85 85 85 85 85 85 85 85 85 85 85 35 85 85 85 85 85 85 85 85 85 85 85 85 85 85 35 85 85 85 85 35 85 85 85 35 85 85 85 85 85 85 85 85 85 85 85 85 85 85 85 85 85 85 85 85 85 85 85 85 85 35 85 85 85 85 85 85 85 85 85 85 85 85 85 85 85 85 85 85 85 85 85 5
5 85 85 85 85 85 85 85 85 85 85 85 85 35 35 35 35 35 35 85 85 85 85 85 85 85 85 85 85 85 85 85 85 85 35 35 85 85 85 85 85 85 85 85 85 85 85 85 85 85 85 85 85 85 85 85 85 85 35 35 35 85 85 85 85 85 85 85 85 85 85 85 85 85 85 85 85 85 35 85 85 85 85 85 85 85 85 85 85 85 85 85 85 85 85 85 85 85 85 5
5 85 85 85 85 85 85 85 85 85 85 85 85 85 85 85 85 85 85 85 85 85 85 85 85 85 85 85 85 85 85 85 85 85 85 85 85 85 85 85 85 85 85 85 85 85 85 85 85 85 85 85 85 85 85 85 85 85 85 85 35 35 35 35 85 85 85 85 85 85 85 85 85 85 85 85 85 85 85 85 85 85 85 85 85 85 85 85 85 85 35 35 35 35 35 35 85 85 85 5
5 85 85 85 85 85 85 85 85 85 85 85 85 85 85 85 85 85 85 85 85 85 85 85 85 85 85 85 85 85 85 85 85 85 85 85 85 85 85 85 85 85 85 85 85 85 85 85 85 85 85 85 85 85 35 85 85 85 85 85 85 85 85 35 35 35 35 35 35 35 35 35 35 35 85 85 85 85 85 85 85 85 85 85 35 35 35 35 35 35 85 85 85 85 85 85 35 85 85 5
5 35 35 35 35 35 35 35 35 35 35 35 85 85 85 85 85 85 85 85 35 35 35 35 35 35 35 35 35 35 35 35 35 85 85 85 85 85 35 35 35 35 35 35 35 35 35 35 35 35 35 35 35 35 35 35 85 85 85 85 85 85 85 85 85 85 85 85 85 85 85 85 85 85 85 85 35 85 85 85 35 35 35 35 35 85 85 85 85 85 85 85 85 85 85 85 85 85 85 5
5 85 85 85 85 85 85 85 85 85 85 85 85 85 85 85 85 85 85 85 85 85 85 85 85 85 85 85 85 85 85 85 85 85 85 85 85 85 85 85 85 85 85 85 85 85 85 85 85 85 85 85 85 85 85 85 85 85 85 85 85 85 85 85 85 85 85 85 85 85 85 85 85 85 85 85 85 85 85 85 85 85 85 85 85 85 85 85 85 85 85 85 85 85 85 85 85 85 35 5
5 85 85 85 85 85 85 85 85 85 85 85 85 85 85 85 85 85 85 85 85 85 85 85 85 85 85 85 85 85 85 85 85 85 85 85 85 85 85 85 85 85 85 85 85 85 85 85 85 85 85 85 85 85 85 85 85 85 85 85 85 85 85 85 85 85 85 85 85 85 85 85 85 85 85 85 85 85 85 85 85 85 85 85 85 85 85 85 85 85 85 85 85 85 85 85 85 85 85 5
5 85 85 85 85 85 85 85 85 85 85 85 85 85 85 85 85 85 85 85 85 85 85 85 85 85 85 85 85 85 85 85 85 85 85 85 85 85 85 85 85 85 85 85 85 85 85 85 85 85 85 85 85 85 85 85 85 85 85 85 85 85 85 85 85 85 85 85 85 85 85 85 85 85 85 85 85 85 85 85 85 85 85 85 85 85 85 85 85 85 85 85 85 85 85 85 85 85 85 5
5 5 5 5 5 5 5 5 5 5 5 5 5 5 5 5 5 5 5 5 5 5 5 5 5 5 5 5 5 5 5 5 5 5 5 5 5 5 5 5 5 5 5 5 5 5 5 5 5 5 5 5 5 5 5 5 5 5 5 5 5 5 5 5 5 5 5 5 5 5 5 5 5 5 5 5 5 5 5 5 5 5 5 5 5 5 5 5 5 5 5 5 5 5 5 5 5 5 5 5
