tile.png
60 30
0 0 0 0 0 0 0 0 0 0 0 0 0 0 0 0 0 0 0 0 0 0 0 0 0 0 0 0 0 0 0 0 0 0 0 0 0 0 0 0 0 0 0 0 0 0 0 0 0 0 0 0 0 0 0 0 0 0 0 0
0 80 80 80 80 80 80 80 80 80 80 80 80 80 80 80 80 80 80 80 80 80 80 80 80 80 80 80 80 80 80 80 80 80 80 80 80 80 80 80 80 80 80 80 80 80 80 80 80 80 80 80 80 80 80 80 80 80 80 0
0 80 80 80 80 80 80 80 80 80 80 80 80 80 80 80 80 80 80 80 80 80 80 80 80 80 80 80 80 80 80 80 80 80 80 80 80 80 80 80 80 80 80 80 80 80 80 80 80 80 80 80 80 80 80 80 80 80 80 0
0 80 80 80 80 80 80 80 80 80 80 80 80 80 80 80 80 80 80 80 80 80 80 80 80 80 80 80 80 80 80 80 80 80 80 80 80 80 80 80 80 80 80 80 80 80 80 80 80 80 80 80 80 80 80 80 80 80 80 0
0 20 20 20 20 20 20 80 80 20 20 80 80 80 80 80 80 80 80 80 80 80 20 20 20 20 20 80 80 80 80 20 20 20 80 80 80 80 80 80 80 80 80 80 80 80 80 80 80 80 80 80 80 80 80 80 80 80 80 0
0 80 80 80 80 80 80 20 80 80 80 20 80 80 80 80 80 80 80 80 80 80 80 80 80 80 80 80 80 80 80 80 80 80 20 20 80 80 80 80 80 80 80 80 80 80 80 80 80 80 80 80 80 80 80 80 80 80 80 0
0 80 80 80 80 80 80 80 80 80 80 80 80 20 20 20 20 20 20 20 80 80 80 80 80 80 80 80 80 80 80 80 80 80 80 80 20 80 80 80 80 80 80 80 80 80 80 80 80 80 80 80 80 80 80 80 80 80 80 0
0 80 80 80 80 80 80 80 80 80 80 80 80 80 80 80 80 80 80 80 80 80 80 80 80 80 80 80 80 80 80 80 80 80 80 80 80 20 20 20 20 80 80 80 80 80 80 80 80 80 80 80 80 80 80 80 20 20 20 0
0 20 20 20 20 20 80 80 80 80 80 80 80 80 80 80 80 80 80 80 80 80 80 80 80 80 80 80 80 80 80 80 80 80 80 80 80 80 80 80 80 20 80 80 80 80 80 80 80 80 80 80 80 80 80 20 80 80 80 0
0 80 80 80 80 80 20 80 80 80 80 80 80 80 80 80 80 80 80 80 80 20 20 20 20 20 20 20 20 80 80 80 80 80 80 80 80 80 80 80 80 80 80 80 80 80 80 80 80 80 80 80 20 20 20 80 80 80 80 0
0 80 80 80 80 80 80 20 20 80 80 80 80 80 80 80 80 80 80 80 80 80 80 80 80 80 80 80 80 80 80 80 80 80 80 80 80 80 80 80 80 80 80 80 80 80 80 80 20 20 20 20 80 80 80 80 80 80 80 0
0 80 80 80 80 80 80 80 80 80 80 80 80 80 80 80 80 80 80 80 80 80 80 80 80 80 80 80 80 80 80 80 80 80 80 80 80 80 80 80 80 80 80 80 80 20 20 20 80 80 80 80 80 80 80 80 80 80 80 0
0 80 80 80 80 80 80 80 80 80 80 80 80 80 80 80 80 80 80 80 80 80 80 80 80 80 80 80 80 80 80 80 80 80 80 80 80 80 80 80 80 80 80 80 20 80 80 80 80 80 80 80 80 80 80 80 80 80 80 0
0 20 20 20 20 20 80 80 80 80 80 80 80 20 20 20 20 20 20 20 20 80 80 80 80 80 80 80 20 20 80 80 80 80 80 80 80 80 80 80 80 80 80 20 80 80 80 80 80 80 80 80 80 80 80 80 80 80 80 0
0 80 80 80 80 80 20 20 80 80 80 80 80 80 80 80 80 80 80 80 80 80 80 80 80 80 80 80 80 80 20 20 20 80 80 80 80 80 80 80 80 80 80 80 80 80 80 80 80 80 80 80 80 80 80 80 80 80 80 0
0 80 80 80 80 80 80 80 20 80 80 80 80 80 80 80 80 80 80 80 80 80 80 80 80 80 80 80 80 80 80 80 80 80 80 80 80 80 80 80 80 80 80 80 80 80 80 80 80 80 80 80 80 80 80 80 80 80 80 0
0 80 80 80 80 80 80 80 80 20 80 80 80 80 80 80 80 80 80 80 80 80 80 80 80 80 80 80 80 80 80 80 80 80 80 80 80 80 80 80 80 80 80 80 80 80 80 80 80 80 80 80 80 80 80 80 20 20 20 0
0 80 80 80 80 80 80 80 80 80 80 80 80 80 80 80 80 80 80 80 80 20 20 20 20 20 20 20 80 80 80 80 80 80 20 20 20 20 80 80 80 80 80 80 80 80 80 80 80 80 80 80 80 20 20 20 80 80 80 0
0 20 20 20 20 20 20 80 80 80 80 80 80 80 80 80 80 80 80 80 80 80 80 80 80 80 80 80 80 80 80 80 80 80 80 80 80 20 20 20 20 20 20 20 20 80 80 80 80 80 80 80 80 80 80 80 80 80 80 0
0 80 80 80 80 80 80 20 80 80 80 80 80 80 80 80 80 80 80 80 80 80 80 80 80 80 80 80 80 80 80 80 80 80 80 80 80 80 80 80 80 80 80 80 20 20 20 80 80 80 80 80 80 80 80 80 80 80 80 0
0 80 80 80 80 80 80 80 20 80 80 80 80 80 80 80 80 80 80 80 80 80 80 80 80 80 80 80 80 80 80 80 80 80 80 80 80 80 80 80 80 80 80 80 80 80 20 20 20 20 20 20 80 80 80 80 80 80 80 0
0 80 80 80 80 80 80 80 80 20 80 80 80 20 20 20 20 20 20 20 20 80 80 80 80 80 80 80 80 80 80 80 80 80 80 80 80 80 80 80 80 80 80 80 80 80 80 80 80 80 80 80 80 80 80 80 80 80 80 0
0 80 80 80 80 80 80 80 80 80 80 80 80 80 80 80 80 80 80 80 80 80 80 80 80 80 80 80 80 80 80 80 80 80 80 80 80 80 80 80 80 80 80 80 80 80 80 80 80 80 80 80 80 80 80 80 80 80 80 0
0 80 80 80 80 80 80 80 80 80 80 80 80 80 80 80 80 80 80 80 80 80 80 80 80 80 80 20 80 80 20 20 80 80 80 80 80 80 80 80 80 80 80 80 80 80 80 80 80 80 80 80 80 80 80 80 80 80 80 0
0 80 80 80 80 80 80 80 80 80 80 80 80 80 80 80 80 80 80 80 80 80 80 20 20 20 20 80 80 80 80 80 20 20 20 20 20 20 20 20 20 20 20 20 20 80 80 80 80 80 80 20 20 20 20 80 80 80 80 0
0 20 20 20 20 20 20 20 20 20 20 20 20 80 80 80 80 80 80 80 20 20 20 80 80 80 80 80 80 80 80 80 80 80 80 80 80 80 80 80 80 80 80 80 80 20 20 20 20 20 20 80 80 80 80 20 20 80 80 0
0 80 80 80 80 80 80 80 80 80 80 80 80 80 80 80 80 80 80 80 80 80 80 80 80 80 80 80 80 80 80 80 80 80 80 80 80 80 80 80 80 80 80 80 80 80 80 80 80 80 80 80 80 80 80 80 80 80 80 0
0 80 80 80 80 80 80 80 80 80 80 80 80 80 80 80 80 80 80 80 80 80 80 80 80 80 80 80 80 80 80 80 80 80 80 80 80 80 80 80 80 80 80 80 80 80 80 80 80 80 80 80 80 80 80 80 80 80 80 0
0 80 80 80 80 80 80 80 80 80 80 80 80 80 80 80 80 80 80 80 80 80 80 80 80 80 80 80 80 80 80 80 80 80 80 80 80 80 80 80 80 80 80 80 80 80 80 80 80 80 80 80 80 80 80 80 80 80 80 0
0 0 0 0 0 0 0 0 0 0 0 0 0 0 0 0 0 0 0 0 0 0 0 0 0 0 0 0 0 0 0 0 0 0 0 0 0 0 0 0 0 0 0 0 0 0 0 0 0 0 0 0 0 0 0 0 0 0 0 0
