tile.png
60 30
8 8 8 8 8 8 8 8 8 8 8 8 8 8 8 8 8 8 8 8 8 8 8 8 8 8 8 8 8 8 8 8 8 8 8 8 8 8 8 8 8 8 8 8 8 8 8 8 8 8 8 8 8 8 8 8 8 8 8 8
8 88 88 88 88 88 88 88 88 88 88 88 88 88 88 88 88 88 88 88 88 88 88 88 88 88 88 88 88 88 88 88 88 88 88 88 88 88 88 88 88 88 88 88 88 88 88 88 88 88 88 88 88 88 88 88 88 88 88 8
8 88 88 88 88 88 88 88 88 88 88 88 88 88 88 88 88 88 88 88 88 88 88 88 88 88 88 88 88 88 88 88 88 88 88 88 88 88 88 88 88 88 88 88 88 88 88 88 88 88 88 88 88 88 88 88 88 88 88 8
8 88 88 88 88 88 88 88 88 88 88 88 88 88 88 88 88 88 88 88 88 88 88 88 88 88 88 88 88 88 88 88 88 88 88 88 88 88 88 88 88 88 88 88 88 88 88 88 88 88 88 88 88 88 88 88 88 88 88 8
8 38 38 38 38 88 88 88 88 88 88 88 88 88 88 88 88 88 88 88 88 88 88 88 88 88 88 88 88 88 88 88 88 88 88 88 88 88 88 88 88 88 88 88 88 88 88 88 88 88 88 88 38 38 38 38 38 38 38 8
8 88 88 88 88 38 38 88 88 88 88 88 88 88 88 88 88 88 88 88 88 88 88 88 88 88 88 88 88 88 88 88 88 88 88 88 88 88 88 88 88 88 88 88 88 88 88 88 38 38 38 38 88 88 88 88 88 88 88 8
8 88 88 88 88 88 88 38 88 88 88 88 88 88 88 88 88 88 88 88 88 38 38 38 88 88 88 88 88 88 88 88 38 88 88 88 88 88 88 88 88 88 88 88 88 38 38 38 88 88 88 88 88 88 88 88 88 88 88 8
8 88 88 88 88 88 88 88 38 38 88 88 88 88 88 88 88 88 88 88 38 88 88 88 38 38 38 38 38 38 38 38 88 88 88 88 88 88 88 88 88 88 88 38 38 88 88 88 88 88 88 88 88 88 88 88 88 88 88 8
8 88 88 88 88 88 88 88 88 88 38 38 38 88 88 88 88 88 88 38 88 88 88 88 88 88 88 88 88 88 88 88 88 88 88 88 88 88 88 38 38 38 38 88 88 88 88 88 88 88 88 88 88 88 88 88 88 88 88 8
8 88 88 88 88 88 88 88 88 88 88 88 88 38 38 88 88 88 88 88 88 88 88 88 88 88 88 88 88 88 88 88 88 88 88 88 88 38 38 88 88 88 88 88 88 88 88 88 88 88 88 88 88 88 88 88 88 38 38 8
8 88 88 88 88 88 88 88 88 88 88 88 88 88 88 38 88 88 88 88 88 88 88 88 88 88 88 88 88 88 88 88 88 38 38 38 38 88 88 88 88 88 88 88 88 88 88 88 88 88 88 88 88 88 88 38 38 88 88 8
8 88 88 88 88 88 88 88 88 88 88 88 88 88 88 88 38 38 88 88 88 88 88 88 88 88 88 88 88 88 88 88 38 88 88 88 88 88 88 88 88 88 88 88 88 88 88 88 88 88 88 88 38 38 38 88 88 88 88 8
8 88 88 88 88 88 88 88 88 88 88 88 88 88 88 88 88 88 38 38 88 88 88 88 88 88 88 88 88 88 88 88 88 88 88 88 88 88 88 88 88 88 88 88 88 88 88 88 88 88 38 38 38 88 88 88 88 88 88 8
8 88 88 88 88 88 88 88 88 88 88 88 88 88 88 88 88 88 88 88 38 88 88 88 88 88 88 88 88 88 88 88 88 88 88 88 88 88 88 88 88 88 88 88 88 88 88 38 38 38 88 88 88 88 88 88 88 88 88 8
8 38 38 38 38 88 88 88 88 88 88 88 88 88 88 88 88 88 88 88 88 38 38 88 88 88 88 88 88 88 88 88 88 88 88 88 88 88 88 88 88 88 88 88 38 38 38 88 88 88 88 88 88 88 88 88 88 88 88 8
8 88 88 88 88 38 38 38 38 88 88 88 88 88 88 88 88 88 88 88 88 88 38 88 88 88 88 88 88 38 38 38 38 88 88 88 88 88 88 88 88 88 88 88 88 88 88 88 88 88 88 88 88 88 88 88 88 88 88 8
8 88 88 88 88 88 88 88 88 38 38 38 88 88 88 88 88 88 88 88 88 88 88 38 88 88 88 38 38 88 88 88 88 38 88 88 88 88 88 88 88 88 88 88 88 88 88 88 88 88 88 88 88 88 88 88 88 88 88 8
8 88 88 88 88 88 88 88 88 88 88 88 38 38 38 38 88 88 88 88 88 88 88 88 38 88 88 88 88 88 88 88 88 38 88 88 88 88 88 88 88 88 88 88 88 88 88 88 88 88 88 88 88 88 88 88 88 88 88 8
8 88 88 88 88 88 88 88 88 88 88 88 88 88 88 88 88 88 88 88 88 88 88 88 38 88 88 88 88 88 88 88 88 88 38 88 88 88 38 38 38 38 38 38 38 38 88 88 88 88 88 88 88 88 88 88 88 88 88 8
8 88 88 88 88 88 88 88 88 88 88 88 88 88 88 88 88 88 88 88 88 88 88 38 88 38 88 88 88 88 88 88 88 88 38 88 88 88 88 88 88 88 88 88 88 38 38 38 38 38 88 88 88 88 88 88 88 88 88 8
8 88 88 88 88 88 88 88 88 88 88 88 88 88 88 88 88 88 88 88 88 38 38 88 88 88 38 88 88 88 38 38 88 88 88 38 88 88 88 88 88 88 88 88 88 88 88 88 88 38 38 38 88 88 88 88 88 88 88 8
8 88 88 88 88 88 88 88 88 88 88 88 88 88 88 88 88 38 38 38 38 88 88 88 88 88 88 38 88 88 88 88 88 88 88 88 38 88 88 88 88 88 88 88 88 88 88 88 88 88 88 88 88 88 88 88 88 88 88 8
8 88 88 88 88 88 88 88 88 88 88 88 88 88 38 38 38 88 88 88 88 88 88 88 88 88 88 88 88 88 88 88 88 88 88 88 88 38 38 88 88 88 88 88 88 88 88 88 88 88 88 88 88 88 88 88 88 88 88 8
8 88 88 88 88 88 88 88 88 88 88 88 38 38 88 88 88 88 88 88 88 88 88 88 88 88 88 88 88 88 88 88 88 88 88 88 88 88 88 38 88 88 88 88 88 88 88 88 88 88 88 88 88 88 88 88 88 88 88 8
8 88 88 88 88 88 38 38 38 88 38 38 88 88 88 88 88 88 88 88 88 88 88 88 88 88 88 88 88 38 38 38 88 88 88 88 88 88 88 88 38 38 38 88 88 88 88 88 38 38 38 38 38 88 88 88 88 88 88 8
8 88 88 38 38 38 88 88 88 38 38 88 88 88 88 88 88 88 88 88 88 88 88 38 38 38 38 38 38 88 88 38 38 38 88 88 88 88 88 88 88 88 88 38 38 38 38 38 88 88 88 88 88 38 38 38 88 88 88 8
8 88 88 88 88 88 88 88 88 88 88 88 88 88 88 88 88 88 88 88 88 88 88 88 88 88 88 88 88 88 88 88 88 88 88 88 88 88 88 88 88 88 88 88 88 88 88 88 88 88 88 88 88 88 88 88 88 88 88 8
8 88 88 88 88 88 88 88 88 88 88 88 88 88 88 88 88 88 88 88 88 88 88 88 88 88 88 88 88 88 88 88 88 88 88 88 88 88 88 88 88 88 88 88 88 88 88 88 88 88 88 88 88 88 88 88 88 88 88 8
8 88 88 88 88 88 88 88 88 88 88 88 88 88 88 88 88 88 88 88 88 88 88 88 88 88 88 88 88 88 88 88 88 88 88 88 88 88 88 88 88 88 88 88 88 88 88 88 88 88 88 88 88 88 88 88 88 88 88 8
8 8 8 8 8 8 8 8 8 8 8 8 8 8 8 8 8 8 8 8 8 8 8 8 8 8 8 8 8 8 8 8 8 8 8 8 8 8 8 8 8 8 8 8 8 8 8 8 8 8 8 8 8 8 8 8 8 8 8 8
