tile.png
60 48
1 1 1 1 1 1 1 1 1 1 1 1 1 1 1 1 1 1 1 1 1 1 1 1 1 1 1 1 1 1 1 1 1 1 1 1 1 1 1 1 1 1 1 1 1 1 1 1 1 1 1 1 1 1 1 1 1 1 1 1
1 81 81 81 81 81 81 81 81 81 81 81 81 81 81 81 81 81 81 81 81 81 81 81 81 81 81 81 81 81 81 81 81 81 81 81 81 81 81 81 81 81 81 81 81 81 81 81 81 81 81 81 81 81 81 81 81 81 81 1
1 81 81 81 81 81 81 81 81 81 81 81 81 81 81 81 81 81 81 81 81 81 81 81 81 81 81 81 81 81 81 81 81 81 81 81 81 81 81 81 81 81 81 81 81 81 81 81 81 81 81 81 81 81 81 81 81 81 81 1
1 81 81 81 81 81 81 81 81 81 81 81 81 81 81 81 81 81 81 81 81 81 81 81 81 81 81 81 81 81 81 81 81 81 81 81 81 81 81 81 81 81 81 81 81 81 81 81 81 81 81 81 81 81 81 81 81 31 31 1
1 31 31 31 31 31 31 31 31 31 31 31 31 31 31 31 31 81 81 81 81 81 81 81 81 81 81 81 81 81 81 81 81 81 81 81 81 81 81 81 81 81 81 81 81 81 81 81 81 81 81 81 81 81 81 31 31 31 81 1
1 81 81 81 81 81 81 81 81 81 81 81 81 81 81 81 31 31 81 81 81 81 81 81 81 81 81 81 81 81 81 81 81 81 81 81 81 81 81 81 81 81 81 81 81 81 81 81 81 81 81 81 81 31 31 31 81 81 81 1
1 81 81 81 81 81 81 81 81 81 81 81 81 81 81 81 81 31 31 81 81 81 81 81 81 81 81 81 81 81 81 81 81 81 81 81 81 81 81 81 81 81 81 81 81 81 81 81 81 81 81 31 31 31 81 81 81 81 81 1
1 81 81 81 81 81 81 81 81 81 81 81 81 81 81 81 81 31 31 31 31 31 31 31 31 81 81 31 31 81 81 81 81 81 81 81 81 81 81 81 81 81 81 81 81 81 81 81 81 31 31 31 81 81 81 81 81 81 81 1
1 81 81 31 31 81 81 81 81 81 81 81 81 81 81 81 81 81 81 81 81 81 81 81 81 81 81 81 31 31 31 31 31 31 81 81 81 81 81 81 81 81 81 81 31 31 31 31 31 31 81 81 81 81 81 81 81 81 81 1
1 81 81 81 31 31 31 31 31 81 81 81 81 81 81 81 81 81 81 81 81 81 81 81 81 81 81 81 81 81 81 81 81 31 31 31 31 81 81 81 81 81 81 81 81 81 81 81 81 81 81 81 81 81 81 81 81 81 81 1
1 81 81 81 81 81 81 81 31 31 31 31 31 31 81 81 81 81 81 81 81 81 81 81 81 81 81 81 81 81 81 81 81 81 81 81 31 31 31 81 81 81 81 81 81 81 81 81 81 81 81 81 81 81 81 81 81 81 81 1
1 81 81 81 81 81 81 81 81 81 81 81 81 31 31 31 81 81 81 81 81 81 81 81 81 81 81 81 81 81 81 81 81 81 81 81 81 81 31 31 31 31 81 81 81 81 81 81 81 81 81 81 81 81 81 81 81 81 81 1
1 81 81 81 81 81 81 81 81 81 81 81 81 81 81 81 81 81 81 81 81 81 81 81 81 81 81 81 81 81 81 81 81 81 81 81 81 81 81 81 81 31 31 31 81 81 81 81 81 81 81 81 81 81 81 81 81 81 81 1
1 31 31 31 31 81 81 81 81 81 81 81 81 81 81 81 81 81 31 31 31 31 31 31 81 81 81 81 81 81 81 81 81 81 81 81 81 81 81 81 81 81 81 31 31 31 31 81 81 81 81 81 81 81 81 81 81 81 81 1
1 81 81 81 31 31 31 81 81 81 81 81 81 81 81 81 81 31 81 81 81 81 81 31 31 31 31 81 81 81 81 81 81 81 81 81 81 81 81 81 81 81 81 81 81 81 31 31 31 31 81 81 81 81 81 81 81 81 81 1
1 81 81 81 81 81 31 31 31 31 31 31 81 81 81 81 81 31 81 81 81 81 81 81 81 81 31 31 31 31 31 81 81 81 81 81 81 81 81 81 81 81 81 81 81 81 81 81 81 31 31 31 81 81 81 81 81 81 81 1
1 81 81 81 81 81 81 81 81 81 81 31 31 31 81 81 81 81 81 81 81 81 81 81 81 81 81 81 81 81 81 31 31 31 81 81 81 81 81 81 81 81 81 81 81 81 81 81 81 81 81 31 31 31 81 81 81 81 81 1
1 81 81 81 81 81 81 81 81 81 81 81 81 31 31 31 31 81 81 81 81 81 81 81 81 81 81 81 81 81 81 81 81 81 31 31 31 31 31 31 81 81 81 81 81 81 81 81 81 81 81 81 81 81 31 81 81 81 81 1
1 81 81 81 81 81 81 81 81 81 81 81 81 81 81 81 81 81 81 81 81 81 81 81 81 81 81 81 81 81 81 81 81 81 81 81 81 81 81 81 31 31 31 31 31 31 31 81 81 81 81 81 81 81 81 81 81 81 81 1
1 81 81 81 81 81 81 81 81 81 81 81 81 81 81 81 81 81 81 81 81 81 81 81 81 81 81 81 81 81 81 81 81 81 81 81 81 81 81 81 81 81 81 81 81 81 81 81 81 81 81 81 81 81 81 81 81 81 31 1
1 81 81 81 81 81 81 81 81 81 81 81 81 81 81 81 81 81 81 81 81 81 81 81 81 81 81 81 81 81 81 81 81 81 81 81 81 81 81 81 81 81 81 81 81 81 81 81 81 81 81 81 81 81 81 81 81 31 81 1
1 81 81 81 81 81 81 81 81 81 81 81 31 31 31 31 31 31 31 81 81 81 81 31 31 31 31 31 31 31 81 81 81 81 81 81 81 81 81 81 81 81 81 81 81 81 81 81 81 81 81 81 31 31 31 31 31 81 81 1
1 81 81 81 81 81 81 81 81 31 31 31 81 81 81 81 81 81 31 31 31 31 31 31 81 81 81 81 81 31 31 31 31 31 31 31 31 31 31 31 31 31 31 31 31 31 31 31 31 31 31 31 31 81 81 81 81 81 81 1
1 81 81 81 81 81 81 81 81 81 81 81 81 81 81 81 81 81 81 81 81 81 81 81 81 81 81 81 81 81 81 81 81 81 81 81 81 81 81 81 81 81 81 81 81 81 81 81 81 81 81 81 81 81 81 81 81 81 81 1
1 81 81 81 81 81 81 81 81 81 81 81 81 81 81 81 81 81 81 81 81 81 81 81 81 81 81 81 81 81 81 81 81 81 81 81 81 81 81 81 81 81 81 81 81 81 81 81 81 81 81 81 81 81 81 81 81 81 81 1
1 31 31 31 31 31 31 31 81 81 81 81 81 81 81 81 81 81 81 81 81 81 81 81 81 81 81 81 81 81 81 81 81 81 81 81 81 81 81 81 81 81 81 81 81 81 81 81 81 81 81 81 81 81 81 81 81 81 81 1
1 81 81 81 81 81 81 31 31 31 31 31 31 31 31 81 81 81 81 81 81 81 81 81 81 81 81 81 81 31 31 31 81 81 81 81 81 81 81 81 81 81 81 81 81 81 81 81 81 81 81 81 81 81 81 81 81 81 81 1
1 81 81 81 81 81 81 81 81 81 81 81 81 81 31 31 31 81 81 81 81 81 81 81 81 81 81 81 81 81 81 31 31 31 31 81 81 81 81 81 81 81 81 81 81 81 81 81 81 81 81 81 81 81 81 81 81 81 81 1
1 81 81 81 81 81 81 81 81 81 81 81 81 81 81 81 31 31 31 81 81 81 81 81 81 81 81 81 81 81 81 81 81 81 31 31 81 81 81 81 81 81 81 81 81 81 81 81 81 81 81 81 81 81 81 81 81 81 81 1
1 81 81 81 81 81 81 81 81 81 81 81 81 81 81 81 81 81 31 31 31 31 31 81 81 81 81 81 81 81 81 81 81 81 81 81 81 81 81 81 81 81 81 81 81 81 81 81 81 81 81 81 81 81 81 81 81 81 81 1
1 81 81 81 81 81 81 81 81 81 81 81 81 81 81 81 81 81 81 81 81 81 81 31 31 31 31 31 31 81 81 81 81 81 81 81 81 81 81 81 31 31 31 81 81 81 81 81 31 31 81 81 81 81 81 81 81 81 81 1
1 81 81 81 81 31 31 31 31 81 81 81 81 81 81 81 81 81 81 81 81 81 81 81 81 81 81 81 31 31 31 31 81 81 81 81 81 31 31 81 81 81 31 31 31 31 31 31 31 81 81 81 81 81 81 81 81 81 81 1
1 81 81 31 31 31 81 81 31 31 31 31 81 81 81 81 81 81 81 81 81 81 81 81 81 81 81 81 81 81 81 31 31 31 81 81 81 81 81 81 81 81 81 81 81 81 81 81 81 81 31 81 81 81 81 81 81 81 81 1
1 81 81 81 81 81 81 81 81 81 81 31 31 31 31 31 31 31 31 31 81 81 81 81 81 81 81 81 81 81 81 81 81 31 31 31 81 81 81 81 81 81 81 81 81 81 81 81 81 81 81 81 81 81 81 81 81 81 81 1
1 81 81 81 81 81 81 81 81 81 81 81 81 81 81 81 81 81 81 81 81 81 81 81 81 81 81 81 81 81 81 81 81 81 81 31 31 31 31 31 81 81 81 81 81 81 81 81 81 81 81 31 31 31 81 81 81 81 81 1
1 81 81 81 81 81 81 81 81 81 81 81 81 81 81 81 81 81 81 81 81 81 81 81 81 81 81 81 81 81 81 81 81 81 81 81 81 81 81 31 31 31 81 81 81 81 81 81 81 31 31 31 81 31 31 31 81 81 81 1
1 81 81 81 81 81 81 81 81 81 81 81 81 81 81 81 81 81 81 81 81 81 81 81 81 81 81 81 81 81 81 81 81 81 81 81 81 81 81 81 81 31 31 31 31 31 31 31 31 31 81 81 81 81 81 81 81 81 81 1
1 81 81 81 81 81 81 81 81 81 81 81 81 81 81 81 31 31 31 31 31 31 31 81 81 81 81 81 81 81 81 81 81 81 81 81 81 81 81 81 81 81 81 81 81 81 81 81 81 81 81 81 81 81 81 81 81 81 31 1
1 81 81 81 81 81 31 31 31 31 31 31 31 31 31 31 31 81 81 81 81 81 31 31 31 81 81 81 81 81 81 81 81 81 81 81 81 81 81 81 81 81 81 81 81 81 81 81 81 81 81 81 81 81 81 81 81 31 31 1
1 81 81 81 81 81 81 81 81 81 81 81 81 81 81 81 81 81 81 81 81 81 81 81 31 31 31 31 31 81 81 81 31 31 81 81 31 31 31 81 81 81 81 81 31 31 31 81 81 81 81 81 81 81 81 81 31 81 81 1
1 81 81 81 81 81 81 81 81 81 81 81 81 81 81 81 81 81 81 81 81 81 81 81 81 81 81 81 81 81 81 81 81 81 81 81 81 81 81 81 81 81 81 81 81 81 81 81 81 81 81 81 81 81 81 31 81 81 81 1
1 81 81 81 81 81 81 81 81 81 81 81 81 81 81 81 81 81 81 81 81 81 81 81 81 81 81 81 81 81 81 81 81 81 81 81 81 81 81 81 81 81 81 81 81 81 81 81 81 81 81 81 81 81 31 81 81 81 81 1
1 81 81 81 81 81 81 81 81 81 81 81 81 81 81 81 81 81 81 81 81 81 81 81 81 81 81 81 81 81 81 81 81 81 81 81 81 81 81 81 81 81 81 81 81 81 81 81 81 81 81 81 31 31 81 81 81 81 81 1
1 81 81 81 81 31 31 31 31 31 31 31 31 31 31 31 31 31 31 31 31 31 31 31 31 31 31 31 31 31 31 31 31 31 31 31 31 31 31 31 31 31 31 31 31 31 31 31 31 31 31 31 31 81 81 81 81 81 81 1
1 81 81 81 81 81 81 81 81 81 81 81 81 81 81 81 81 81 81 81 81 81 81 81 81 81 81 81 81 81 81 81 81 81 81 81 81 81 81 81 81 81 81 81 81 81 81 81 81 81 81 81 81 81 81 81 31 31 31 1
1 81 81 81 81 81 81 81 81 81 81 81 81 81 81 81 81 81 81 81 81 81 81 81 81 81 81 81 81 81 81 81 81 81 81 81 81 81 81 81 81 81 81 81 81 81 81 81 81 81 81 81 81 81 81 31 31 81 81 1
1 81 81 81 81 81 81 81 81 81 81 81 81 81 81 81 81 81 81 81 81 81 81 81 81 81 81 81 81 81 81 81 81 81 81 81 81 81 81 81 81 81 81 81 81 81 81 81 81 81 81 81 81 81 81 81 81 81 81 1
1 1 1 1 1 1 1 1 1 1 1 1 1 1 1 1 1 1 1 1 1 1 1 1 1 1 1 1 1 1 1 1 1 1 1 1 1 1 1 1 1 1 1 1 1 1 1 1 1 1 1 1 1 1 1 1 1 1 1 1
